Facebook - facebook.com

YouTube - youtube.com

Instagram - instagram.com

LinkedIn - linkedin.com

TikTok - tiktok.com

Twitter (X) - twitter.com

Snapchat - snapchat.com

Pinterest - pinterest.com

Reddit - reddit.com

Tumblr - tumblr.com

WhatsApp - whatsapp.com

Telegram - telegram.org

Discord - discord.com

WeChat - wechat.com

Vkontakte - vk.com

Douyin - douyin.com

Xiaohongshu (Little Red Book) - xiaohongshu.com

Bilibili - bilibili.com

Quora - quora.com

Meetup - meetup.com

Nextdoor - nextdoor.com

MySpace - myspace.com

Tagged - tagged.com

Hi5 - hi5.com

Renren - renren.com

Badoo - badoo.com

Dribbble - dribbble.com

Medium - medium.com

Yelp - yelp.com

Twitch - twitch.tv

Line - line.me

Blogger - blogger.com

Foursquare - foursquare.com

Flixster - flixster.com

LiveJournal - livejournal.com

Roposo - roposo.com

Likee - likee.com

Yizhibo - yizhibo.com

Douban - douban.com

Rutube - rutube.ru

Youku - youku.com

Zhihu - zhihu.com

Baidu Tieba - tieba.baidu.com

Bluesky - blueskyweb.xyz

9Gag - 9gag.com

Ning - ning.com

Kiwibox - kiwibox.com

XING - xing.com

Meituan-Dianping - meituan.com

Facebook Messenger - messenger.com




